1111111111111
10010000000C1
1100011110101
1P011CE000001
1111111111111