111111111111111111111111
100PN00000000000000000N1
101C1111111111111111C111
10000000000N000000000001
101C1111111111111111C101
10000000000N000000000001
100000011111111111000001
101111010000000010111101
10000001EC00000000000001
101110111111111011111101
100000000000000000000001
101111111111111111111101
100000000000000000000001
100111110000000011111001
111C1111111111111111C101
11N000000000000000000001
111111111111111111111111